<< 西北岁月 >>

// 富平县

- 严木兰 : 富平县第一高小校长
- 秦木兰 : 连城女子学校教师	
- 程建文 : 共产党
	

- 魏海 : 富平县反动派	
	
	
// 西北

//- 徐列   : 共产党, 第二师六旅连长
- 唐澍   : 共产党, 新编第三旅参谋长		// 第二师六旅军事教官, 中共党团书记
- 刘志丹 : 共产党, 陕西特委军委书记		// 新编第三旅参谋主任
- 李象九 : 共产党, 第二师六旅三连连长
//- 王泰吉 : 共产党, 麟游起义领导人
- 谢子长 : 共产党, 新编第三旅副营长		// 第二师六旅十二连连长
- 许权中 : 共产党, 新编第三旅旅长
- 何寓础 : 共产党, 渭南县组织部部长
- 高岗   : 共产党, 陕西特委委员
- 杨国栋 : 共产党, 陕西特委书记
- 周冬至 : 共产党, 革命委员会主席
- 孟坚   : 共产党, 陕西省委书记
- 金理科 : 共产党, 特委书记
- 赵伯平 : 共产党, 三原县委书记
- 刘约三 : 共产党, 二十六军供给部部长
- 萧章   : 共产党, 省委
- 秦武山 : 共产党, 特委书记
- 贾拓夫 : 共产党, 省委秘书长
- 徐海东 : 共产党, 十五军团军团长
- 贺晋年 : 共产党, 十五军团八十一师师长
- 李维汉 : 共产党, 总政治部地方工作部部长
- 王首道 : 共产党, 保卫局局长
- 宋任穷 : 共产党, 二十八军政委
- 郭炳坤 : 共产党, 军事部副部长, 游击队总指挥
- 张凤岐 : 共产党, 组织部部长
- 霍维德 : 共产党, 行政督察专员公署专员
- 聂眉初 : 共产党
- 袁任远 : 共产党, 绥德分区专员
- 安志文 : 共产党

- 王世泰 : 共产党, 游击队二大队长
- 程双印 : 共产党, 游击队特务队队长
- 黄子文 : 共产党, 渭北特委委员
- 黄子祥 : 共产党, 第四团团长
//- 李妙斋 : 共产党, 游击队队长
- 陈学鼎 : 共产党, 游击队队长
- 张邦英 : 共产党, 游击队党代表
- 张仲良 : 共产党, 游击队副队长
- 杨森   : 共产党, 第四团政委
- 李天保 : 共产党, 第四团参谋长
- 王柏栋 : 共产党, 第四团一连指导员
- 张秀山 : 共产党, 游击队政委
- 张策   : 共产党, 四十二师特派员
- 马文瑞 : 共产党, 革命委员会主席
- 吴岱峰 : 共产党, 革命委员会参谋长
- 蔡子伟 : 共产党, 特委组织部长兼秘书长
- 顾林   : 共产党, 特委特派委员
- 方一江 : 共产党, 工委查田工作组组长


- 李秉荣 : 共产党, 国民党第一师第二营三连连长
- 李特生 : 共产党, 国民党第一师第二营三连文书
//- 刘景文 : 共产党, 省委军委秘书, 原名 刘林圃
- 高祥生 : 共产党, 国民党第一师第二营二连排长
- 吕剑人 : 共产党, 国民党第一师第二营一连二排排长
- 左文辉 : 共产党, 国民党第一师第二营三连排长

- 杜衡   : 共产党, 二十六军政委, 叛徒
- 宋文梅 : 共产党
- 陈克敏 : 共产党叛徒, 游击队特务队中队长


- 马鸿逵 : 国民党第二集团军第四军总指挥
- 宋哲远 : 国民党陕西省主席
- 王德修 : 国民党第一师第二营营长
- 王泰吉 : 杨虎城骑兵团团长


// 习家

- 习仲恺 : 弟
- 习秋英 : 大妹
- 习冬英 : 二妹
- 习夏英 : 三妹
- 习燕英 : 小妹

// 刘志丹家

- 刘培基 : 父
- 刘景范 : 弟
- 同桂荣 : 妻




// 





// 





// 





// 







